Time:10,MemFree,Buffers,Cached,Active,Inactive,Active(anon),Inactive(anon),Active(file),Inactive(file),Dirty,Writeback,Mapped,Slab
140,122396,40076,2100716,831468,1917368,610676,556,220792,1916812,6916,0,256680,312368
161,110876,41564,2108976,868716,1911888,632672,540,236044,1911348,60,0,258636,316200
171,105584,44068,2110408,871376,1915076,634576,540,236800,1914536,0,0,263032,317080
182,115404,44016,2110336,889080,1914728,652068,544,237012,1914184,36,0,263168,317328
192,122024,44044,2112384,877548,1916800,640524,540,237024,1916260,68,0,263312,317328
201,119892,44060,2112420,879208,1916828,642160,540,237048,1916288,16,0,263332,317320
211,98116,44096,2112444,888236,1916876,651184,540,237052,1916336,96,0,263476,317360
221,99308,44188,2112496,896148,1917008,659080,540,237068,1916468,40,0,264584,317552
231,112408,44204,2112504,884700,1917016,647612,540,237088,1916476,4,0,263580,317512
241,112452,44220,2112512,883984,1917028,646884,540,237100,1916488,0,0,263576,317416
251,91260,44284,2112520,893456,1917084,656348,540,237108,1916544,148,0,263652,317504
261,78372,43948,2113432,922356,1917584,685164,352,237192,1917232,0,0,267852,317976
271,91324,43964,2113440,909124,1917608,671932,352,237192,1917256,28,0,267980,318048
281,90032,43972,2113448,910220,1917616,673020,352,237200,1917264,0,0,267964,318040
292,94752,44008,2115640,898908,1917884,659748,348,239160,1917536,4,0,264408,318016
301,96340,44028,2116032,897136,1918268,657952,348,239184,1917920,28,0,264448,318080
311,96116,44036,2116920,896544,1919144,657340,348,239204,1918796,0,0,264348,318176
321,93944,44052,2117868,898148,1920100,658932,348,239216,1919752,0,0,264404,318288
331,82880,44060,2118208,906876,1920428,667640,348,239236,1920080,60,0,265624,318472
341,89064,44084,2118216,911884,1920460,672648,348,239236,1920112,8,0,265664,318496
351,88064,44140,2118256,910828,1920524,671568,348,239260,1920176,112,0,265724,318552
361,91904,43816,2118216,922644,1920136,683356,348,239288,1919788,172,0,265656,318576
372,91908,43892,2119272,918068,1921000,678524,460,239544,1920540,96,0,266060,318656
381,94900,43908,2119288,915624,1921016,676052,460,239572,1920556,0,0,266076,318704
391,75364,43940,2119320,922300,1921044,682704,460,239596,1920584,88,0,266240,318800
401,79544,44024,2119360,930176,1921168,690568,460,239608,1920708,0,0,266204,318960
411,86392,44216,2119340,925240,1919656,683952,460,241288,1919196,0,0,266604,319016
421,115688,44548,2119408,964856,1856312,659820,460,305036,1855852,232,0,265312,321512
431,113600,45068,2119624,964368,1856752,659036,656,305332,1856096,0,0,258312,323032
441,67300,45520,2118132,1020092,1855520,714588,464,305504,1855056,372,4,272708,324920
452,96520,45580,2117792,998340,1855224,692800,548,305540,1854676,4,0,272888,324320
463,100040,45604,2117584,993944,1855004,688368,352,305576,1854652,48,0,270060,324304
472,97288,45620,2117624,996448,1855036,690848,352,305600,1854684,4,16,270080,324352
482,103800,45664,2110968,978064,1847924,671964,348,306100,1847576,0,0,266956,324144
492,107364,45684,2110404,976112,1846632,669264,348,306848,1846284,28,0,266936,324232
502,106376,45700,2110404,977124,1845692,669320,348,307804,1845344,4,0,266932,324200
512,106988,45708,2110420,977784,1844732,668996,348,308788,1844384,24,0,266936,324200
522,95692,45716,2110440,988492,1844608,679560,348,308932,1844260,64,0,268128,324456
532,98696,45800,2110432,998612,1844476,689504,348,309108,1844128,136,0,264992,324376
543,92676,45848,2110444,993312,1844552,684180,348,309132,1844204,112,0,265172,324552
552,83856,45904,2110508,1002312,1844636,693144,348,309168,1844288,36,0,265228,324584
562,91416,45928,2110524,990716,1844668,681540,348,309176,1844320,0,0,265136,324632
572,92732,45944,2110528,989396,1844676,680208,348,309188,1844328,28,0,265116,324568
582,71248,45992,2110552,998376,1844708,689156,348,309220,1844360,152,0,265220,324584
593,90524,46048,2110248,997648,1844340,688300,348,309348,1843992,4,0,265200,324704
602,109212,46308,2110536,983832,1841576,671172,544,312660,1841032,200,0,267264,323792
613,102532,46624,2110360,989856,1841660,677140,348,312716,1841312,4,0,267356,323960
623,89956,47112,2110388,989928,1842120,677156,356,312772,1841764,8,76,263592,324248
632,84344,47616,2117164,1023900,1845576,707752,364,316148,1845212,264,48,268260,325232
643,81844,48304,2118940,1039732,1838956,714052,672,325680,1838284,44,0,279788,326352
652,63836,48356,2062984,1093220,1760180,745104,32448,348116,1727732,336,0,334580,322008
662,64480,48460,1975796,1115368,1662440,756248,41044,359120,1621396,216,0,348784,322624
672,76276,48532,1929932,1115740,1605044,744928,37440,370812,1567604,124,0,341476,322768
683,71692,48600,1930436,1114680,1605628,743880,37440,370800,1568188,0,0,339480,322984
692,75516,48608,1930476,1110504,1605644,739672,37440,370832,1568204,76,0,339548,323032
702,76588,48624,1930716,1109612,1605880,738760,37440,370852,1568440,32,0,339560,322968
712,82952,48672,1930872,1103876,1605952,732988,37440,370888,1568512,204,0,340004,323160
722,71148,48692,1936700,1108520,1611844,737580,37440,370940,1574404,76,0,341180,323296
733,70892,48716,1936680,1109284,1611852,738348,37440,370936,1574412,28,0,341272,323368
742,65436,48788,1932860,1120408,1605816,747184,37440,373224,1568376,140,0,340740,323216
753,58520,48864,1932536,1124548,1605524,751280,37440,373268,1568084,136,0,342480,323272
762,76640,48892,1929212,1116464,1599456,740424,37440,376040,1562016,96,0,340784,322632
772,78520,48908,1929220,1115064,1599468,739012,37440,376052,1562028,28,0,340788,322760
782,77264,48928,1929224,1116208,1599492,740152,37440,376056,1562052,28,0,340728,322760
793,68208,49008,1919500,1133296,1587580,754976,37440,378320,1550140,140,0,343272,322768
802,74724,49036,1919760,1121068,1587776,742724,37444,378344,1550332,68,0,341244,322864
813,79936,49716,1920076,1120892,1587480,741192,37436,379700,1550044,140,0,341436,323816
822,75848,50176,1920624,1123128,1588452,743392,37588,379736,1550864,140,0,338456,324080
832,70056,50356,1920256,1138008,1588176,758232,37484,379776,1550692,48,0,335376,323168
843,79288,50808,1914372,1153396,1576140,766968,43256,386428,1532884,152,0,349852,323880
852,72284,50744,1895884,1166796,1553156,775828,49636,390968,1503520,84,8,356852,323736
863,73364,50800,1898784,1166384,1555952,775364,52472,391020,1503480,60,0,359684,324208
873,74740,50668,1884968,1167420,1537312,771704,47040,395716,1490272,16,0,350940,323896
882,84256,50736,1885360,1163084,1537728,767328,47040,395756,1490688,28,0,350180,324040
893,99544,50752,1885508,1144516,1537900,748768,47040,395748,1490860,4,0,350552,324104
902,101916,50768,1885544,1142632,1537932,746868,47040,395764,1490892,48,0,350524,324104
913,80280,50816,1885564,1148784,1537988,753004,47040,395780,1490948,24,0,350560,324104
922,87164,50844,1886144,1141592,1538584,745800,47040,395792,1491544,76,0,350184,323984
932,83620,50868,1886156,1143744,1538612,747944,47040,395800,1491572,32,0,350220,324128
942,86120,50988,1886184,1153088,1538736,757264,47040,395824,1491696,148,0,352208,324192
952,74112,51016,1886196,1153728,1538748,757876,47040,395852,1491708,124,0,350256,324144
963,90792,51084,1886208,1147536,1538816,751672,47040,395864,1491776,108,0,350316,324320
972,95636,51100,1886244,1143460,1538836,747572,47040,395888,1491796,16,0,350228,324264
982,95352,51108,1886252,1144868,1538852,748972,47040,395896,1491812,36,0,350228,324192
992,81172,51200,1886492,1157728,1539164,761820,47040,395908,1492124,20,0,352296,324288
1002,92940,51236,1886488,1148116,1539176,752180,47040,395936,1492136,80,0,350328,324264
1012,96244,51724,1887092,1146724,1535636,746156,47040,400568,1488596,268,220,350240,320752
1022,91916,51772,1887128,1149608,1535728,749048,47040,400560,1488688,80,0,350464,324440
1033,76528,52404,1887824,1151824,1537016,751224,47236,400600,1489780,40,0,342848,325512
1043,67204,52792,1886984,1189632,1533900,786368,47240,403264,1486660,28,0,355540,325208
1052,86532,53048,1885276,1170092,1530036,764416,47044,405676,1482992,104,0,354140,325088
1063,67456,53112,1887912,1174760,1532628,768976,47044,405784,1485584,88,0,355004,325432
1072,64340,53144,1888332,1176100,1533056,770292,47044,405808,1486012,12,0,355068,325624
1082,83044,53172,1888084,1176352,1532768,770476,47044,405876,1485724,120,0,353512,325760
1093,79716,52644,1861240,1200124,1493408,782264,47236,417860,1446172,44,0,356092,324392
1102,85440,52668,1861084,1192212,1493244,774316,47044,417896,1446200,68,0,355372,324672
1113,65104,52716,1861204,1200104,1493412,782208,47044,417896,1446368,80,0,355212,324712
1123,82148,52756,1862044,1183232,1493972,765016,47044,418216,1446928,84,0,352324,325168
1132,72572,52772,1861272,1191936,1493480,773984,47044,417952,1446436,4,0,353512,325408
1142,79412,52824,1861292,1198280,1493492,780268,47044,418012,1446448,76,0,352928,325440
1152,84992,52856,1861308,1189592,1493520,771560,47044,418032,1446476,96,0,352996,325504
1162,70968,52940,1861344,1203248,1493628,785204,47044,418044,1446584,124,0,353000,325784
1172,86044,52964,1861360,1187568,1493660,769516,47044,418052,1446616,44,0,352984,325896
1182,86076,52972,1861368,1187988,1493660,769920,47044,418068,1446616,28,0,352984,325856
1192,68020,53020,1861380,1194432,1493704,776356,47044,418076,1446660,60,0,353024,325744
1202,71068,53096,1861572,1202592,1493956,784492,47044,418100,1446912,124,0,352928,325688
1212,81368,53256,1861580,1187444,1494120,769340,47048,418104,1447072,120,0,352308,325784
1224,76508,53808,1861484,1194784,1494464,776568,47240,418216,1447224,0,0,356448,327024
1256,64744,54520,1848988,1213972,1482560,795644,47044,418328,1435516,72,0,354148,325616
1266,93180,54628,1849564,1186540,1483240,768200,47240,418340,1436000,8,0,355240,325800
1276,100104,54648,1849568,1178892,1483236,760524,47240,418368,1435996,44,0,354924,325928
1287,99300,54664,1849548,1179560,1483240,761200,47240,418360,1436000,24,0,354940,325960
1296,93964,54672,1849580,1184884,1483252,766496,47240,418388,1436012,12,0,355144,325992
1307,66404,54720,1849572,1198880,1483312,780488,47240,418392,1436072,4,0,357028,326344
1317,61116,54736,1834308,1233212,1467840,814620,47048,418592,1420792,68,0,361964,325808
1327,64868,54752,1834444,1227416,1467976,808808,47052,418608,1420924,20,36,360216,327680
1337,74508,54296,1832596,1222032,1465636,803388,47048,418644,1418588,72,0,360484,327544
1346,70072,54308,1832600,1222868,1465644,804216,47048,418652,1418596,28,0,359940,327760
1356,88416,54352,1832880,1197260,1465932,778580,47044,418680,1418888,8,0,355988,327504
1366,90672,54368,1832892,1194676,1465968,775996,47044,418680,1418924,4,0,355996,327360
1376,90828,54376,1832904,1194272,1465960,775564,47044,418708,1418916,4,0,355972,327376
1386,91260,54396,1832908,1193736,1465992,775036,47044,418700,1418948,8,0,355988,327344
1397,79672,54412,1832896,1204064,1465980,785348,47044,418716,1418936,4,0,357212,327712
1406,78884,54476,1832996,1217780,1466088,799008,47044,418772,1419044,116,0,356384,327920
1416,68244,54528,1833648,1215572,1466776,796784,47044,418788,1419732,112,0,356588,328056
1427,73940,54604,1833896,1220796,1467084,801992,47044,418804,1420040,128,4,358640,328088
1438,60124,54828,1837852,1223804,1470456,804192,47044,419612,1423412,16,0,360392,330840
1448,63536,54112,1833264,1225704,1465104,806044,47044,419660,1418060,8,0,360112,331232
1458,60960,54136,1834080,1227364,1465936,807696,47044,419668,1418892,4,0,360556,331544
1468,65932,54152,1834084,1220852,1465944,801172,47044,419680,1418900,40,0,360676,331832
1477,95224,54424,1817376,1221684,1449320,801756,47240,419928,1402080,324,0,364920,331416
1487,107608,54464,1817864,1214188,1449752,794224,47240,419964,1402512,76,0,364756,331848
1497,64012,54520,1818048,1224804,1449976,804824,47240,419980,1402736,104,4,363852,332344
1507,79104,54588,1818304,1222036,1450284,802040,47240,419996,1403044,116,0,364156,332432
1517,80484,54900,1818372,1223856,1450636,803832,47240,420024,1403396,220,0,362548,329608
1528,96548,54972,1818400,1218448,1450708,798396,47240,420052,1403468,128,0,362448,329576
1537,98640,55028,1818420,1205224,1450744,784992,47240,420232,1403504,136,0,361020,329512
1548,88272,55048,1818428,1213156,1450768,793060,47240,420096,1403528,72,0,362236,329880
1557,89332,55100,1821396,1222048,1453740,801908,50180,420140,1403560,112,0,364024,329688
1567,71512,55132,1823932,1229268,1456208,809024,52704,420244,1403504,28,0,373208,330120
1578,65408,54128,1803776,1242760,1434944,822412,47540,420348,1387404,356,0,368052,329600
1587,106348,54152,1804368,1215560,1435492,795148,47540,420412,1387952,452,0,367848,329776
1597,97444,54164,1803496,1223552,1434624,803128,47540,420424,1387084,16,0,369012,330112
1608,65276,51676,1759304,1252688,1387704,832020,47540,420668,1340164,164,0,372660,329648
1618,70972,52960,1727608,1282492,1356640,861176,47540,421316,1309100,156,0,378048,330904
1628,93304,52860,1718224,1289388,1347128,868044,47540,421344,1299588,108,0,376492,330480
1637,79848,52948,1713532,1294896,1342496,873532,47540,421364,1294956,228,0,374396,331024
1647,70816,52768,1706264,1300240,1334968,878788,47540,421452,1287428,136,0,375020,330832
1657,89160,52832,1706292,1280624,1335036,859148,47540,421476,1287496,140,0,374392,330968
1668,66872,52896,1706284,1282840,1335060,861332,47540,421508,1287520,80,0,375720,331088
1678,100908,52924,1706332,1263960,1335104,842428,47540,421532,1287564,104,0,375532,331208
1688,90628,52948,1706308,1273216,1335092,851668,47540,421548,1287552,8,0,376672,331744
1697,62556,53176,1701780,1308256,1330828,886668,47540,421588,1283288,16,0,378916,332176
1707,57072,53348,1691060,1320152,1320200,898556,47544,421596,1272656,180,0,381912,332192
1717,70188,52892,1682980,1321576,1310704,899020,47544,422556,1263160,184,0,382032,332656
1728,79076,52916,1670964,1322880,1296312,897924,47544,424956,1248768,12,0,382896,331848
1737,91148,52956,1673028,1308788,1297696,883112,47540,425676,1250156,172,0,378468,331680
1748,105416,52976,1670984,1299440,1295664,873764,47540,425676,1248124,36,0,378300,331840
1758,108036,52992,1670976,1297400,1295684,871728,47540,425672,1248144,44,0,378300,331984
1768,106860,53008,1670984,1297428,1295700,871748,47540,425680,1248160,8,0,378320,331976
1777,96592,53016,1671036,1306900,1295732,881192,47540,425708,1248192,4,0,379460,332144
1787,93760,53036,1671048,1309076,1295744,883348,47540,425728,1248204,4,0,379568,332336
1797,59832,53080,1672704,1344904,1297404,919212,47540,425692,1249864,76,0,383560,332272
1807,71200,53120,1672716,1336132,1297524,910432,47544,425700,1249980,4,0,383836,332408
1817,62908,52436,1639140,1353204,1254248,918592,47552,434612,1206696,64,0,385356,331904
1828,65352,52572,1638792,1361484,1252268,925000,47544,436484,1204724,140,0,384980,332064
1837,74692,52604,1633236,1348668,1246704,912144,47540,436524,1199164,20,0,378764,331440
1848,81976,52620,1633216,1341708,1246700,905184,47540,436524,1199160,8,0,378360,331616
1858,80176,52648,1633284,1342544,1246784,906008,47540,436536,1199244,4,0,378388,331816
1867,63008,52676,1633332,1344240,1246832,907676,47540,436564,1199292,96,0,378984,331976
1877,64768,52696,1624036,1349864,1237572,913284,47540,436580,1190032,64,0,379160,331248
1887,91344,52744,1620084,1357156,1233348,920288,47540,436868,1185808,164,0,379572,330832
1897,95224,52760,1620092,1352488,1233352,915600,47540,436888,1185812,36,0,379944,331280
1907,93652,52776,1620100,1353568,1233368,916672,47540,436896,1185828,40,0,380004,331264
1917,90244,52792,1620100,1354636,1233376,917732,47540,436904,1185836,40,0,380084,331248
1927,91240,52800,1620116,1353948,1233400,917044,47540,436904,1185860,28,0,380100,331392
1937,89528,52816,1620124,1354164,1233416,917252,47540,436912,1185876,24,0,380160,331352
1947,95148,52832,1620132,1349428,1233424,912500,47540,436928,1185884,20,0,379980,331360
1957,95632,52848,1620140,1349016,1233440,912080,47540,436936,1185900,20,0,380052,331480
1968,96352,52864,1620120,1348472,1233448,911548,47540,436924,1185908,36,0,380060,331448
1978,95552,52880,1620160,1348764,1233472,911832,47540,436932,1185932,72,0,380068,331464
1987,74868,53220,1617080,1341660,1229524,903496,47540,438164,1181984,580,0,375604,330776
1997,67020,53244,1616188,1348744,1228660,910584,47540,438160,1181120,72,0,376716,330880
2007,66704,53264,1616196,1349180,1228680,911016,47540,438164,1181140,72,0,376764,330952
2018,76944,53324,1612840,1377504,1223608,937560,47544,439944,1176064,204,0,378704,331080
2027,65148,53356,1609016,1375504,1219396,935140,47544,440364,1171852,176,0,378756,330664
2037,82656,53408,1589808,1382256,1199480,941136,47544,441120,1151936,152,0,378812,330680
2047,75644,53428,1575016,1381008,1184708,939884,47544,441124,1137164,116,0,380028,329568
2057,86808,53492,1576484,1370496,1186180,929328,47540,441168,1138640,600,0,376496,329728
2067,102168,54388,1575028,1360108,1185636,918940,47540,441168,1138096,92,0,376244,329792
2077,102392,54404,1575036,1359884,1185652,918708,47540,441176,1138112,28,0,376248,329768
2087,102332,54412,1575056,1359864,1185676,918684,47540,441180,1138136,28,0,376252,329784
2098,83664,54444,1575056,1369724,1185696,928540,47540,441184,1138156,28,0,377600,329784
2108,81080,54464,1575076,1371152,1185732,929956,47540,441196,1138192,76,0,377744,330024
2118,104272,54536,1575468,1375020,1186112,933740,47540,441280,1138572,112,0,377052,330344
2128,173948,54628,1575492,1322872,1184756,880120,47540,442752,1137216,128,0,376228,331152
2138,175648,54716,1575544,1333228,1184868,890448,47540,442780,1137328,148,0,376068,331312
2148,188344,54828,1575780,1320288,1185172,877464,47540,442824,1137632,16,0,371900,330840
2158,203640,55036,1575840,1312332,1183504,867572,47540,444760,1135964,168,4,373288,331584
2167,196852,55264,1576436,1316492,1184296,871700,47540,444792,1136756,128,0,374548,331520
2178,196012,55308,1576428,1316840,1184324,872040,47540,444800,1136784,140,0,374596,331488
2187,204232,55428,1576464,1307328,1184464,862512,47540,444816,1136924,104,0,373320,331832
2197,196728,55528,1576480,1303924,1184556,859084,47540,444840,1137016,232,0,372740,331472
2207,199180,55788,1576364,1312876,1184684,868020,47540,444856,1137144,112,0,374912,331408
2218,193188,55856,1576528,1306880,1184928,862036,47540,444844,1137388,116,0,374912,331400
2228,196648,55936,1576840,1315676,1185304,870816,47540,444860,1137764,144,0,375816,331384
2238,216716,56028,1576880,1295368,1185364,850436,47540,444932,1137824,8,0,369604,331192
2248,203316,56484,1576888,1309676,1185864,864780,47540,444896,1138324,196,0,373128,331168
2257,195448,56544,1576928,1303008,1185928,858076,47540,444932,1138388,168,0,372928,331216
2267,198808,56608,1577876,1310688,1186920,865740,47540,444948,1139380,112,0,373876,331344
2277,210040,56632,1577264,1298772,1186232,853792,47540,444980,1138692,8,0,372552,331368
2287,195088,56676,1577556,1300056,1186636,855072,47540,444984,1139096,84,0,372772,331448
2298,151272,56736,1578596,1336100,1187720,891100,47540,445000,1140180,184,0,374440,331464
2307,160516,56796,1578656,1328028,1187760,882948,47540,445080,1140220,188,0,371128,331672
2318,130252,56848,1578696,1337516,1187768,892360,47540,445156,1140228,68,0,371500,331760
2327,162852,56904,1580288,1321504,1189388,876312,47540,445192,1141848,116,0,369560,331672
2338,177532,57028,1578832,1311964,1188028,866744,47540,445220,1140488,24,0,369172,331608
2348,178256,57036,1578808,1310464,1188028,865260,47540,445204,1140488,44,0,369280,331712
2357,178708,57052,1578844,1309652,1188060,864428,47540,445224,1140520,32,0,369248,331760
2367,168864,57068,1578860,1318860,1188080,873624,47540,445236,1140540,36,0,370408,331904
2377,167104,57088,1578872,1319460,1188092,874204,47540,445256,1140552,36,0,370484,331952
2387,113228,58112,1582784,1358244,1192860,912832,47544,445412,1145316,184,0,373372,331968
2398,116480,58260,1587532,1337224,1197740,891784,47540,445440,1150200,1980,0,371556,331992
2408,126516,58280,1583948,1331004,1194176,885564,47540,445440,1146636,96,0,371500,331752
2417,126612,58296,1583992,1330716,1194216,885256,47540,445460,1146676,8,0,371500,331800
2427,126940,58312,1583996,1330192,1194220,884716,47540,445476,1146680,12,0,371504,331816
2438,109520,58332,1583988,1340304,1194228,894824,47540,445480,1146688,24,0,372788,331784
2447,107956,58384,1584040,1341888,1194308,896384,47540,445504,1146768,96,0,372796,331768
2458,91924,58456,1573836,1372956,1181880,925156,47540,447800,1134340,136,0,378036,331600
2468,80856,58620,1543912,1420756,1147428,968264,47540,452492,1099888,16,0,383216,329552
2478,57136,58656,1544368,1441268,1147808,988588,47540,452680,1100268,44,4,384244,329888
2487,183884,58708,1542944,1353288,1137556,891812,47540,461476,1090016,16,0,373076,329480
2497,182428,58720,1542964,1354236,1137584,892748,47540,461488,1090044,8,0,373168,329608
2507,138224,58804,1543928,1393660,1138484,932124,47540,461536,1090944,240,0,381252,329872
2518,120712,58848,1543924,1390860,1138620,929320,47540,461540,1091080,52,0,381336,329992
2528,136172,58884,1543964,1396988,1138688,935440,47540,461548,1091148,112,0,381340,330200
2538,74852,58940,1544012,1420116,1138656,958432,47540,461684,1091116,124,0,382920,330160
2547,129496,58952,1544580,1400728,1139200,939012,47540,461716,1091660,288,0,381792,330160
2558,134980,59000,1545500,1376692,1140156,914960,47540,461732,1092616,60,0,380324,330192
2567,135672,59012,1544088,1377128,1138740,915380,47540,461748,1091200,4,0,380292,330352
2578,136144,59028,1544064,1376652,1138736,914908,47540,461744,1091196,4,0,380312,330320
2588,136516,59044,1544096,1376520,1138764,914756,47540,461764,1091224,40,0,380308,330344
2598,119084,59068,1544088,1386016,1138780,924252,47540,461764,1091240,44,0,381588,330384
2607,117216,59092,1544132,1386676,1138824,924888,47540,461788,1091284,64,0,381636,330496
2617,143044,59152,1544144,1390508,1138872,928696,47540,461812,1091332,100,0,381116,330720
2627,134124,59176,1545972,1398644,1140720,936828,47540,461816,1093180,24,0,381448,330584
2637,136748,59244,1546012,1392264,1140788,930412,47540,461852,1093248,48,0,381528,330536
2647,135948,59428,1546064,1403988,1141012,942124,47540,461864,1093472,160,0,382484,330576
2657,142456,59444,1546104,1392972,1141068,931108,47540,461864,1093528,76,0,381128,330528
2667,145280,59516,1546112,1391920,1141120,930024,47540,461896,1093580,88,0,381144,330672
2677,144764,59560,1547060,1381112,1142060,919164,47540,461948,1094520,556,0,379668,330704
2687,138152,59580,1546152,1388248,1141168,926296,47540,461952,1093628,68,0,380772,330752
2697,137168,59596,1546164,1388936,1141184,926972,47540,461964,1093644,52,0,380820,330984
2708,115404,59656,1546208,1395260,1141264,933276,47544,461984,1093720,12,0,381624,331024
2717,113328,59672,1546312,1395388,1141376,933392,47540,461996,1093836,8,0,381736,331088
2727,106416,59704,1546500,1402456,1141580,940444,47540,462012,1094040,80,0,381080,331024
2737,126884,59732,1547428,1381960,1142548,919960,47540,462000,1095008,516,0,379880,330960
2747,117756,59752,1546524,1390884,1141648,928868,47540,462016,1094108,56,0,381004,331096
2758,115920,59780,1546508,1392328,1141664,930316,47540,462012,1094124,16,0,381048,331232
2767,91788,59888,1548148,1417960,1143368,955904,47544,462056,1095824,164,0,382672,332008
2777,89372,59948,1548216,1420036,1143464,957964,47544,462072,1095920,112,0,382684,332048
2787,63096,60000,1533020,1448160,1128292,986044,47544,462116,1080748,112,0,386948,330128
2797,105120,60052,1533068,1431160,1128368,969020,47544,462140,1080824,144,0,382600,330520
2808,94404,60100,1533068,1433960,1128408,971812,47544,462148,1080864,20,0,381508,330256
2817,132496,60128,1534024,1401792,1129348,939600,47544,462192,1081804,52,0,379628,330432
2827,121804,60148,1533112,1409864,1128448,947664,47544,462200,1080904,4,0,380764,330664
2837,125764,60188,1533124,1419184,1128468,956952,47544,462232,1080924,12,0,380544,330776
2848,131444,60224,1533132,1412360,1128504,950128,47544,462232,1080960,80,0,380860,330896
2857,117188,60300,1533196,1425652,1128592,963360,47544,462292,1081048,40,0,380908,330800
2867,132252,60328,1533208,1410748,1128644,948468,47544,462280,1081100,4,0,380824,330824
2877,132156,60344,1533216,1410644,1128652,948348,47544,462296,1081108,28,0,380836,330816
2887,114720,60384,1533228,1415468,1128684,953152,47544,462316,1081140,8,0,380848,330872
2897,117304,60464,1533260,1425776,1128776,963440,47544,462336,1081232,88,0,380852,330984
2907,115852,60548,1533516,1421808,1129068,959424,47544,462384,1081524,4,0,380840,331288
2918,169396,60792,1533524,1387192,1128324,923812,47540,463380,1080784,136,0,386332,328032
2931,139488,61644,1533840,1401784,1129360,938340,47540,463444,1081820,168,0,388688,331856
2944,174928,62360,1534676,1378504,1130800,914880,47540,463624,1083260,104,0,381032,332144
2954,166692,62436,1535172,1385728,1131348,922080,47548,463648,1083800,20,0,388124,331616
2963,132524,62620,1539052,1403376,1135224,939564,47540,463812,1087684,180,0,389104,332072
2974,107360,62664,1541108,1404916,1137148,940908,47544,464008,1089604,104,0,386720,332136
2983,98376,62848,1543728,1408256,1139752,944048,47544,464208,1092208,196,0,387580,332240
2993,93372,63340,1543900,1412204,1140368,947948,47544,464256,1092824,8,0,389860,332744
3003,95404,63356,1543908,1409908,1140384,945644,47544,464264,1092840,0,0,389868,332832
3075,83760,63700,1544360,1423748,1141036,959340,47540,464408,1093496,148,0,389432,333384
3085,96220,63736,1544376,1410024,1141080,945604,47540,464420,1093540,12,0,388928,333240
3094,97096,63752,1544416,1408800,1141112,944356,47540,464444,1093572,4,0,388908,333176
3104,98604,63764,1544424,1408032,1141124,943580,47540,464452,1093584,0,0,388844,333224
3114,84520,63856,1544448,1421904,1141220,957432,47540,464472,1093680,0,0,388828,333424
3124,95952,63864,1544472,1410332,1141220,945828,47540,464504,1093680,100,0,388864,333520
3134,98536,63872,1544480,1407708,1141204,943172,47540,464536,1093664,36,0,388852,333560
3144,97792,63884,1544488,1408392,1141232,943868,47540,464524,1093692,24,0,388868,333528
3154,80056,63928,1544512,1413544,1141268,948988,47540,464556,1093728,84,0,388892,333376
3164,81128,63944,1544520,1412468,1141292,947908,47540,464560,1093752,24,0,388924,333432
3174,81020,63952,1544524,1412424,1141292,947852,47540,464572,1093752,8,0,388920,333528
3184,93488,63956,1545472,1399912,1142212,935316,47540,464596,1094672,480,0,387412,333616
3194,80552,63976,1544548,1412504,1141296,947888,47540,464616,1093756,12,0,388580,333760
3204,82660,64004,1544564,1410076,1141316,945444,47540,464632,1093776,16,0,388600,333680
3214,94472,64056,1544552,1410064,1141356,945424,47540,464640,1093816,40,0,388712,333672
3224,80556,64160,1544636,1424596,1141476,959892,47540,464704,1093936,204,0,389724,333720
3234,96312,64180,1544628,1408456,1141484,943744,47540,464712,1093944,112,0,388664,333840
3244,97364,64196,1544644,1407324,1141500,942596,47540,464728,1093960,20,0,388688,333816
3254,90452,64228,1544652,1414208,1141532,949472,47540,464736,1093992,68,0,388644,334024
3264,80960,64308,1544684,1423336,1141600,958556,47540,464780,1094060,144,4,389756,333904
3274,94416,64336,1544692,1411400,1141628,946612,47540,464788,1094088,8,0,388704,333984
3284,87152,64496,1544708,1413620,1141756,948784,47540,464836,1094216,100,0,388488,334440
3309,105324,65624,1544880,1410872,1140652,943632,47540,467240,1093112,292,0,385288,333864
3318,110652,65716,1544936,1405976,1140780,938716,47540,467260,1093240,12,0,387336,333760
3328,112948,65732,1544948,1402960,1140780,935672,47540,467288,1093240,68,0,388084,333768
3338,85704,65888,1544532,1419544,1139792,951532,47540,468012,1092252,100,0,387472,334096
3348,88000,65908,1544792,1419768,1139852,951536,47544,468232,1092308,108,0,387656,334072
3358,76956,66032,1545236,1431208,1140236,962792,47540,468416,1092696,240,0,384840,334144
3368,86112,66096,1545272,1420328,1140332,951908,47540,468420,1092792,124,0,385080,334128
3378,112084,66224,1545296,1399768,1139600,930464,47540,469304,1092060,20,0,387176,334680
3389,96580,66480,1545304,1414820,1139788,945440,47540,469380,1092248,60,0,387336,334808
3403,103868,67112,1545240,1410068,1140132,940464,47540,469604,1092592,104,0,379800,334680
3413,117844,67296,1545492,1397320,1140456,927604,47544,469716,1092912,116,0,384888,334728
3423,107956,67348,1545292,1406504,1140252,936732,47536,469772,1092716,68,0,386520,334624
3434,126516,67368,1545316,1388868,1140328,919128,47540,469740,1092788,56,0,385324,334368
3444,126512,67384,1545296,1388616,1140320,918872,47540,469744,1092780,20,0,385368,334544
3453,114080,67392,1545336,1398368,1140336,928592,47540,469776,1092796,36,0,386604,334560
3463,99180,67444,1545508,1400424,1140556,930644,47540,469780,1093016,148,0,385400,334536
3473,81444,67460,1545516,1401152,1140560,931352,47540,469800,1093020,4,0,385932,334648
3484,81808,67484,1543888,1423124,1138940,953312,47540,469812,1091400,92,0,388776,334288
3493,66140,67716,1540012,1426896,1135216,957000,47548,469896,1087668,268,0,391956,334088
3503,61128,67736,1537152,1427564,1132356,957648,47548,469916,1084808,88,0,392236,333448
3514,71688,67752,1535284,1421044,1130512,951136,47548,469908,1082964,28,0,392580,333464
3523,114948,67784,1531372,1422156,1126600,952216,47548,469940,1079052,64,0,392436,332848
3534,61880,67812,1526304,1444860,1120872,974232,47548,470628,1073324,104,0,395972,333120
3543,86904,67828,1525396,1442064,1119544,971000,47548,471064,1071996,276,0,395648,333568
3554,110636,67864,1524912,1403432,1119020,932292,47540,471140,1071480,108,0,389924,333384
3563,111588,67872,1524920,1402008,1119028,930860,47540,471148,1071488,36,0,389880,333296
3574,109988,67884,1524924,1403220,1119036,932064,47540,471156,1071496,76,0,389880,333368
3584,110704,67900,1524892,1402368,1119028,931220,47540,471148,1071488,40,0,389896,333272
3593,75392,67916,1524956,1413080,1119072,941896,47540,471184,1071532,84,0,393416,333624
3603,71444,67948,1524976,1415672,1119112,944476,47540,471196,1071572,84,0,394364,333920
3613,72672,67964,1524988,1415872,1119132,944668,47540,471204,1071592,24,0,393968,333784
3623,80584,68016,1525036,1419400,1119204,948168,47548,471232,1071656,168,0,392528,333912
3634,92156,68028,1525004,1420404,1119180,949168,47548,471236,1071632,36,0,393008,333856
3644,96036,68036,1525388,1414812,1119560,943564,47548,471248,1072012,36,0,393040,333880
3654,88156,68048,1525432,1416764,1119576,945496,47548,471268,1072028,104,0,395420,333968
3663,84568,68088,1524472,1420584,1118612,949252,47548,471332,1071064,60,0,395624,333960
3673,85004,68104,1524480,1420164,1118636,948832,47548,471332,1071088,8,0,395580,334000
3683,88660,68116,1525688,1408388,1117020,934220,47548,474168,1069472,520,0,390040,333760
3693,93012,68128,1524484,1406044,1115812,931860,47548,474184,1068264,44,0,389816,333384
3703,92448,68140,1524484,1406208,1115808,932008,47548,474200,1068260,36,0,389816,333408
3713,91528,68148,1524500,1406892,1115828,932688,47548,474204,1068280,36,0,389820,333392
3723,81192,68156,1524508,1417016,1115828,942796,47548,474220,1068280,4,0,390756,333432
3733,64916,68196,1523284,1416148,1114600,941884,47540,474264,1067060,0,0,389416,332752
3743,58052,68316,1518300,1477112,1107212,1000496,47540,476616,1059672,6196,20,398068,332512
3753,68244,68356,1516600,1466264,1105252,989176,47540,477088,1057712,192,0,397156,332808
3763,74380,68372,1502180,1484456,1089108,1005628,47540,478828,1041568,144,0,396588,332232
3774,64688,68388,1489108,1495196,1076064,1016380,47540,478816,1028524,0,0,397756,331328
3784,122280,68420,1490732,1457772,1077232,978616,47540,479156,1029692,124,0,392384,331576
3793,125216,68436,1489340,1455980,1076292,977112,47540,478868,1028752,32,0,392344,331656
3804,124768,68452,1489320,1455896,1076292,977032,47540,478864,1028752,40,0,392340,331568
3813,126320,68464,1489356,1454620,1076312,975728,47540,478892,1028772,36,0,392372,331728
3823,115276,68480,1489372,1463808,1076316,984888,47540,478920,1028776,72,0,393544,331696
3833,112632,68500,1489384,1465980,1076356,987068,47540,478912,1028816,72,0,393660,331752
3844,97520,68516,1489396,1465060,1076364,986128,47540,478932,1028824,48,0,392188,331920
3853,87408,68572,1491644,1489800,1077648,1009848,47540,479952,1030108,100,0,393472,332080
3863,57588,68604,1490800,1486996,1076688,1007012,47540,479984,1029148,148,0,393228,331928
3873,65604,68628,1487952,1485164,1073972,1005172,47540,479992,1026432,8,0,393804,331408
3883,108852,68648,1483352,1485136,1069472,1005232,47540,479904,1021932,20,0,393692,331032
3893,62952,68676,1469088,1511060,1055332,1031204,47540,479856,1007792,128,0,399104,330744
3903,65652,68696,1469916,1501156,1056112,1021280,47540,479876,1008572,408,0,394148,331376
3913,113880,68724,1469156,1467060,1055368,987164,47540,479896,1007828,84,0,391908,331544
3924,115568,68736,1469136,1465924,1055360,986028,47540,479896,1007820,32,0,391964,331496
3933,115384,68744,1469172,1465932,1055380,986012,47540,479920,1007840,40,0,391912,331480
3943,114420,68756,1469180,1466628,1055380,986696,47540,479932,1007840,28,0,391916,331528
3953,78644,68772,1469208,1477420,1055408,997464,47540,479956,1007868,92,0,394572,332088
3964,85672,68880,1469224,1495928,1055420,1015860,47540,480068,1007880,84,0,396540,332208
3973,78308,68992,1470048,1500092,1056280,1019948,47540,480144,1008740,12,0,397536,332440
3984,70672,69016,1470972,1505908,1056196,1024732,47576,481176,1008620,104,0,398364,332408
3993,86108,69084,1471024,1495644,1056264,1014416,47576,481228,1008688,92,0,398148,332680
4003,82148,69128,1471088,1496968,1056280,1015648,47568,481320,1008712,20,0,396560,332704
4014,91500,69184,1458228,1498448,1043468,1017128,47568,481320,995900,900,0,394908,331000
4023,100072,69204,1456704,1496124,1041948,1014780,47568,481344,994380,88,0,394484,331184
4034,110284,69224,1456684,1485524,1041956,1004188,47568,481336,994388,36,0,394552,331320
4043,110496,69236,1456716,1485404,1041976,1004044,47568,481360,994408,32,0,394512,331400
4053,121372,69288,1456792,1486052,1041972,1004564,47568,481488,994404,76,0,393392,331440
4063,110952,69308,1457312,1495068,1041832,1012904,47568,482164,994264,8,0,394628,331744
4101,67212,69528,1471192,1513536,1051856,1027296,47620,486240,1004236,24,0,397440,331616
4112,73648,69568,1471220,1503564,1051872,1017272,47620,486292,1004252,72,0,397780,331768
4121,73512,69620,1471688,1503632,1051880,1016820,47592,486812,1004288,16,0,397732,331792
4131,73920,69620,1471772,1502860,1051880,1015968,47592,486892,1004288,0,0,397732,332088
4142,73868,69628,1471752,1503564,1051872,1016676,47592,486888,1004280,4,0,397756,332192
4151,74888,69644,1471788,1502252,1051900,1015340,47592,486912,1004308,32,0,397736,332240
4162,74908,69660,1471768,1502180,1051904,1015276,47592,486904,1004312,4,0,397752,332288
4171,73260,69672,1472316,1503072,1051924,1015628,47592,487444,1004332,32,0,397776,332384
4182,74204,69680,1472300,1502436,1051912,1014988,47592,487448,1004320,0,0,397752,332448
4191,73852,69696,1472336,1502956,1051940,1015484,47592,487472,1004348,32,0,397736,332272
4201,73620,69712,1472884,1503304,1052008,1015344,47620,487960,1004388,20,0,397768,332232
4212,70108,69724,1473416,1506796,1052020,1018296,47632,488500,1004388,52,0,397800,332128
4221,76396,69748,1473844,1503180,1051908,1014112,47540,489068,1004368,60,0,397696,332144
4232,68040,69808,1471860,1510952,1047840,1019748,47560,491204,1000280,160,0,398044,331696
4241,66840,69860,1472444,1512632,1047932,1020880,47572,491752,1000360,96,0,398000,331808
4251,68272,69896,1472492,1510380,1048000,1018612,47576,491768,1000424,12,0,398004,331960
4262,66996,69900,1472984,1512744,1047968,1020448,47576,492296,1000392,12,0,397992,332096
4271,67824,69904,1473020,1510964,1047980,1018640,47576,492324,1000404,8,0,398008,332128
4281,68752,69916,1473028,1510292,1047976,1017944,47576,492348,1000400,8,0,398004,332112
4292,69116,69924,1473008,1509772,1047976,1017436,47576,492336,1000400,8,0,398024,332248
4301,69592,69936,1473044,1509064,1047996,1016700,47576,492364,1000420,8,0,398008,332448
4312,68968,69944,1473396,1509572,1047984,1016836,47576,492736,1000408,4,0,398056,332272
4322,69680,69960,1473432,1509176,1048012,1016416,47576,492760,1000436,8,0,398008,332152
4332,69672,69972,1473440,1509304,1048020,1016532,47576,492772,1000444,8,0,398024,332240
4343,65520,69988,1473456,1513532,1048052,1020760,47612,492772,1000440,8,0,398084,332304
4352,61388,70064,1452800,1514436,1027308,1021496,47540,492940,979768,144,0,398312,330632
4362,75520,70124,1449464,1501972,1024024,1009024,47540,492948,976484,596,0,396940,330288
4372,67724,70184,1448596,1509188,1023184,1016208,47540,492980,975644,40,0,398012,330560
4382,67456,70192,1448612,1509500,1023192,1016504,47540,492996,975652,12,0,398140,330920
4392,104564,70272,1193048,1583980,758272,1081552,48176,502428,710096,132,0,403064,321184
4403,64600,70296,1187348,1583892,751660,1081000,48456,502892,703204,7680,0,404176,319488
4414,64680,70320,1224268,1587016,786916,1081928,48584,505088,738332,2336,0,404316,318520
4426,63772,70336,1266956,1590104,826932,1082428,48624,507676,778308,5536,0,404312,318048
4437,135168,70348,1206684,1595380,763588,1084648,47992,510732,715596,372,0,403852,317968
4449,73460,70544,1233092,1619096,767540,1085712,53280,533384,714260,36,0,414228,318832
4459,66688,70668,1214804,1667432,732296,1116968,47992,550464,684304,20,0,424288,318896
4470,81016,70736,1137156,1674528,691840,1161188,47992,513340,643848,12,0,410564,319200
4479,194264,70772,1136672,1570760,691040,1056972,47544,513788,643496,108,0,401964,318816
4489,191948,70788,1136672,1571392,691048,1057596,47544,513796,643504,44,0,401976,319016
4500,82000,70832,1137340,1620428,691704,1106576,48180,513852,643524,32,0,403872,319896
4512,81656,70864,1137352,1616564,691716,1102684,48180,513880,643536,48,0,404200,319824
4522,65396,70884,1137276,1616788,691652,1102896,48084,513892,643568,8,0,404012,319664
4534,68200,70916,1137324,1611444,691604,1097424,48180,514020,643424,48,0,404016,319712
4544,112024,70952,1137612,1564824,691888,1050752,47544,514072,644344,456,0,402564,319624
4558,105284,70972,1136744,1571424,691012,1057336,47544,514088,643468,72,0,403648,319624
4569,104704,70996,1136756,1571908,691040,1057808,47544,514100,643496,64,0,403432,319592
4580,79772,71036,1119860,1615784,676492,1104000,48180,511784,628312,2700,0,404652,317824
4591,112148,71112,1121272,1591076,675856,1077164,47544,513912,628312,212,0,404280,317536
4600,95324,71152,1121292,1592872,675848,1078892,47544,513980,628304,116,0,412880,317840
4611,136184,71184,1111492,1649320,666688,1135980,47540,513340,619148,92,0,406028,317344
4622,151296,71272,1109476,1666108,663904,1152356,48184,513752,615720,1272,0,409440,317968
4632,116644,71412,1047768,1662900,604416,1150756,47800,512144,556616,160,0,442328,318104
4642,245100,71488,1047864,1622420,604556,1110244,47800,512176,556756,0,0,409496,318160
4652,253292,71512,1047808,1614280,604508,1102088,47736,512192,556772,128,0,409116,318248
4662,252456,71528,1047812,1615048,604520,1102848,47736,512200,556784,48,0,409188,318392
4673,94900,71576,1048592,1665872,605308,1153632,48372,512240,556936,32,0,411764,319072
4684,132332,71680,1051140,1620048,607064,1106912,47736,513136,559328,16,0,411464,318688
4693,137112,71736,1053204,1629972,607132,1114784,47736,515188,559396,24,0,409236,318840
4704,128932,71780,1053188,1628728,607180,1113560,47736,515168,559444,100,0,409024,318720
4714,142140,71820,1053240,1629064,607224,1113848,47736,515216,559488,32,0,408968,318584
4724,96260,71884,1053288,1658384,607284,1143116,47736,515268,559548,44,0,411972,318672
4734,125152,71936,1053316,1637836,607356,1122560,47736,515276,559620,8,0,412052,318808
4744,106000,71980,1053340,1644868,607416,1129584,47736,515284,559680,20,0,416616,318808
4754,142492,72020,1053352,1618960,607452,1103660,47736,515300,559716,92,0,415188,318720
4764,138244,72036,1053336,1621672,607448,1106368,47736,515304,559712,40,0,415908,319168
4774,119420,72056,1053384,1624180,607484,1108844,47736,515336,559748,32,0,416288,319296
4785,96236,72072,1053392,1627956,607504,1112616,47736,515340,559768,20,0,416504,319088
4795,65620,72144,1055408,1664240,609600,1148832,47736,515408,561864,12,0,418772,319456
4805,63940,72188,1054132,1664628,608176,1149108,47844,515520,560332,136,0,419084,319912
4815,66412,72260,1054216,1668120,608240,1152504,47800,515616,560440,36,4,419128,319840
4826,80828,72300,1054596,1674152,608624,1158504,47736,515648,560888,16,0,417916,321112
4835,106180,72444,1055476,1636412,609576,1120684,47736,515728,561840,464,0,411528,321040
4846,99484,72452,1054656,1642912,608732,1127160,47736,515752,560996,64,0,412504,321016
4855,98420,72464,1054700,1643544,608756,1127760,47736,515784,561020,4,0,412560,321152
4866,134800,72512,1054724,1650648,608808,1134844,47736,515804,561072,32,0,411160,321080
4876,122076,72568,1055104,1650540,609220,1134712,47736,515828,561484,52,0,413904,323712
4886,75808,72636,1060980,1680736,614944,1164888,47736,515848,567208,132,0,412632,323760
4896,78180,72684,1064088,1713116,618220,1197188,47736,515928,570484,140,0,412884,323536
4907,94732,73860,1060760,1735512,614884,1218404,47736,517108,567148,312,0,408556,323472
4916,116796,73904,1060816,1712532,614752,1195188,47736,517344,567016,8,0,410360,323400
4926,261064,73968,1062756,1636172,616664,1118736,47736,517436,568928,8,0,405832,323280
4937,275904,76344,1062772,1630868,617972,1112348,47736,518520,570236,228,4,405732,321776
4946,298540,76368,1061104,1611132,616276,1092560,47736,518572,568540,4,0,404152,321520
4956,297768,76372,1061116,1611408,616276,1092820,47736,518588,568540,0,0,404192,321424
4966,297600,76396,1061124,1611692,616276,1093072,47736,518620,568540,88,0,404220,321552
4976,298268,76412,1061120,1611092,616296,1092480,47736,518612,568560,24,0,404224,321640
4986,288424,76428,1061144,1621700,616324,1103076,47736,518624,568588,100,0,405304,321720
4996,272236,76456,1061180,1624788,616336,1106120,47736,518668,568600,0,0,404140,321848
5008,159792,76764,1119568,1663860,673908,1144000,48296,519860,625612,2336,24,421140,323648
5017,126940,76884,1139832,1698708,689260,1174080,51112,524628,638148,96,0,428336,324728
5029,87836,77432,1145996,1698636,694940,1172772,51124,525864,643816,160,0,432628,326472
5038,63292,77464,1142908,1727628,691180,1201060,51124,526568,640056,48,0,442944,325464
5048,86268,77512,1144952,1702228,693244,1175632,51128,526596,642116,484,0,433440,326016
5059,104276,77524,1142924,1698420,691244,1171840,51128,526580,640116,8,0,432640,326072
5068,122456,77540,1142960,1680200,691272,1153596,51128,526604,640144,4,0,432656,326144
5079,122940,77552,1142940,1679868,691268,1153268,51128,526600,640140,8,0,432680,326096
