Time:10,MemFree,Buffers,Cached,Active,Inactive,Active(anon),Inactive(anon),Active(file),Inactive(file),Dirty,Writeback,Mapped,Slab
2018,1576564,2836,378072,696928,248380,564508,472,132420,247908,152,48,231260,67332
2028,1588120,2876,383340,681612,252916,548388,472,133224,252444,36,0,225548,67000
2038,1574944,3032,394684,699588,256296,558252,480,141336,255816,396,0,227856,66648
2048,1566056,3140,396696,707888,258368,566476,476,141412,257892,44,0,228664,66704
2059,1563956,3180,396928,709628,258572,568176,464,141452,258108,64,0,228688,66600
2068,1563740,3352,397352,708108,259068,566556,464,141552,258604,0,0,228772,67128
2078,1568360,3384,399568,703420,260416,560968,464,142452,259952,64,0,228416,66748
2088,1567116,3416,399700,704984,260576,562528,464,142456,260112,16,0,228488,66860
2099,1554368,3564,401168,714556,261972,571880,464,142676,261508,80,0,228916,66892
2109,1545732,3668,401480,723568,262360,580864,464,142704,261896,96,0,229036,66908
2119,1529820,3908,402720,736592,263040,593088,464,143504,262576,72,0,231756,67468
2129,1515368,4116,403252,745036,263616,601372,464,143664,263152,248,40,233972,68384
2140,1521808,4180,403972,741120,264328,597380,464,143740,263864,0,0,233612,68504
2149,1521044,4300,404048,740800,264440,597028,480,143772,263960,364,0,233572,68520
2160,1522036,4332,404104,740436,264572,596656,480,143780,264092,76,0,233584,68504
2169,1459064,4544,415312,788960,275608,644908,484,144052,275124,48,0,235568,68604
2179,1456912,4596,416172,791404,276580,647300,480,144104,276100,48,0,235748,68860
2189,1465272,4620,416448,782236,276816,638116,480,144120,276336,4,0,235744,68784
2199,1437188,4776,417276,795368,277776,651176,464,144192,277312,100,0,236084,69100
2210,1444836,4880,417584,787020,278052,642788,464,144232,277588,444,0,236104,69272
2219,1445720,5016,417528,785184,278200,640924,464,144260,277736,52,0,236108,69604
2229,1441424,5048,417600,788384,278296,644116,464,144268,277832,20,0,236428,69804
2239,1447648,5132,417468,785184,277064,639744,464,145440,276600,20,0,235656,69376
2249,1446856,5160,417484,784448,277100,638988,464,145460,276636,32,0,235672,69528
2260,1444144,5272,417428,788976,277176,643536,464,145440,276712,36,0,235776,69600
2269,1436376,5360,417508,796200,277336,650748,464,145452,276872,456,0,235760,69648
2279,1428944,5480,417552,801428,277492,655972,464,145456,277028,64,4,236052,69820
2290,1436416,5560,417584,795748,277592,650280,464,145468,277128,64,0,236100,69704
2299,1440424,5664,417504,791872,277600,646388,464,145484,277136,40,0,237368,69692
2309,1433700,6020,430064,787008,288512,639588,444,147420,288068,92,0,236688,69824
2319,1433516,6308,432704,785000,291248,637340,444,147660,290804,120,0,237004,69928
2329,1432372,6608,432832,786104,291668,638436,460,147668,291208,4,0,237080,70044
2339,1434224,6772,432836,783920,291816,636232,460,147688,291356,16,0,237080,69964
2349,1421812,6880,432912,796024,292000,648336,460,147688,291540,52,0,237136,69960
2359,1425160,6932,432936,789952,292052,642240,460,147712,291592,48,0,237424,70060
2370,1421176,7072,432980,796600,292228,648880,472,147720,291756,28,0,237132,70120
2380,1428008,7152,433336,787248,292644,639508,444,147740,292200,148,0,237124,70028
2389,1430472,7240,433260,786892,292664,639160,444,147732,292220,100,0,237136,69964
2399,1424388,7392,433268,790544,292804,642792,444,147752,292360,0,0,237452,70076
2409,1441948,7480,433396,776284,292752,628264,444,148020,292308,184,0,235624,69800
2419,1433508,7512,433144,783472,292524,635444,444,148028,292080,60,0,236880,69864
2429,1428356,7612,433188,787508,292636,639448,444,148060,292192,0,0,236972,69944
2439,1414392,7684,433112,802760,292612,654680,444,148080,292168,72,0,236904,69928
2449,1420976,7820,433200,795756,292804,647652,444,148104,292360,76,0,237064,70036
2460,1414320,7884,433260,801732,292916,653604,440,148128,292476,48,0,237340,70048
2469,1425452,7988,433240,791452,292988,643316,444,148136,292544,388,0,237352,69920
2479,1420928,8248,433248,802404,284644,645656,444,156748,284200,68,0,236908,69740
2489,1418808,8456,433280,806600,282384,647352,444,159248,281940,0,0,236944,69996
2499,1403880,8708,442212,814020,291332,654536,448,159484,290884,404,0,238836,69928
2509,1389764,8820,447712,821704,296736,662056,448,159648,296288,64,0,240752,69984
2519,1358324,8976,469512,830588,318412,670616,580,159972,317832,92,0,248048,70324
2529,1347192,9100,473352,835236,321940,674832,612,160404,321328,36,0,248608,70308
2540,1350332,9156,474132,832124,322736,671676,576,160448,322160,76,0,248968,70224
2550,1332200,9188,474376,849568,322976,689084,576,160484,322400,4,0,249132,70268
2559,1344964,9252,474720,835892,323348,675376,576,160516,322772,232,56,249240,70420
2569,1344632,9324,474696,834636,323352,674072,576,160564,322776,28,0,249172,70324
2580,1343572,9408,474812,836128,323492,675504,576,160624,322916,24,0,249528,70620
2589,1360720,9480,474900,821504,323592,660820,576,160684,323016,68,0,247724,70244
2599,1347908,9508,474632,831700,323312,670976,576,160724,322736,4,0,249180,70412
2609,1343596,9604,474516,836076,323252,675312,576,160764,322676,264,4,249184,70456
2619,1335744,9656,474600,842928,323312,682136,576,160792,322736,120,0,248964,70436
2630,1337384,9756,474644,843208,323496,682408,576,160800,322920,24,0,248968,70508
2639,1327824,9832,474620,849824,323524,689000,576,160824,322948,56,0,249280,70588
2649,1343504,9936,474580,837600,323540,676728,576,160872,322964,52,0,249320,70524
2659,1332900,10136,474580,844236,323676,683304,576,160932,323100,12,4,249860,70480
2669,1337800,10396,474600,842140,323872,681120,576,161020,323296,0,0,249200,70604
2679,1334808,10620,474472,845008,323820,683920,576,161088,323244,240,0,249216,70552
2689,1333200,10740,474720,846480,324152,685276,576,161204,323576,48,0,249324,70552
2699,1321524,10852,474748,856780,324248,695528,628,161252,323620,56,0,249800,70796
2710,1333512,10888,474732,846760,324180,685424,576,161336,323604,0,0,249208,70568
2719,1329884,10920,474744,849992,324208,688640,576,161352,323632,0,0,249216,70520
2729,1336976,10956,474744,840928,324220,679552,576,161376,323644,36,0,249240,70480
2739,1337744,11012,474792,842396,324312,680984,576,161412,323736,192,0,249244,70492
2749,1338292,11116,474924,840364,324480,678908,576,161456,323904,52,0,249264,70524
2759,1338652,11140,474972,839016,324528,677536,576,161480,323952,28,0,249264,70456
2769,1341536,11200,474776,837200,324340,675668,576,161532,323764,56,0,248848,70300
2779,1342664,11224,474828,836540,324372,674964,576,161576,323796,0,0,249004,70460
2789,1334140,11308,474736,842792,324332,681184,576,161608,323756,152,0,249032,70496
2799,1328320,11388,474840,851836,324476,690188,576,161648,323900,152,0,249064,70480
2809,1320656,11472,474844,855716,324508,694012,576,161704,323932,4,0,249324,70560
2819,1335784,11556,474832,843508,324560,681784,576,161724,323984,4,0,249304,70552
2830,1334752,11636,474768,844432,324560,682692,576,161740,323984,28,0,249400,70516
2839,1330864,11928,474824,847044,324812,685208,576,161836,324236,40,0,249460,70656
2849,1326696,12104,474804,852588,324928,690712,576,161876,324352,0,0,249372,70592
2860,1284092,12448,492236,881532,336004,713132,576,168400,335428,224,0,251716,70676
2869,1253112,12724,497940,898320,338916,726676,704,171644,338212,0,0,254464,71628
2879,1235572,12928,498824,909288,339840,737480,708,171808,339132,136,0,255244,72416
2892,1083972,13364,547104,933100,384132,756868,33960,176232,350172,276,0,301256,73084
2902,1076712,13452,548456,940764,385252,764212,34696,176552,350556,4,0,302452,73352
2913,1071824,13504,548748,944636,385568,768056,34696,176580,350872,84,0,302380,73532
2923,1078512,13568,548640,940276,385484,763656,34696,176620,350788,56,0,302460,73368
2932,1074928,13628,548648,940804,385536,764172,34696,176632,350840,20,0,302812,73776
2942,1093004,13668,548760,925220,385628,748524,34696,176696,350932,0,0,301172,73344
2952,1084140,13708,548472,934304,385356,757584,34696,176720,350660,48,0,302200,73440
2962,1077824,13776,548428,939848,385308,763084,34696,176764,350612,400,0,302280,73520
2973,1072000,13836,548500,945028,385420,768216,34696,176812,350724,192,0,302284,73516
2982,1071616,13856,548496,946092,385440,769284,34696,176808,350744,4,0,302300,73452
2993,1073644,13872,548528,945136,385452,768292,34696,176844,350756,16,0,302284,73484
3002,1068784,13960,548548,948308,385504,771408,34696,176900,350808,212,0,302656,73464
3012,1073236,13980,548444,943504,385400,766584,34696,176920,350704,60,0,302656,73460
3022,1076084,14048,548492,941980,385488,765032,34712,176948,350776,376,0,302696,73416
3033,1077696,14088,548508,939308,385492,762308,34712,177000,350780,52,0,302684,73356
3042,1072044,14128,548524,943984,385516,766952,34712,177032,350804,64,0,302560,73556
3052,1075208,14148,548508,941680,385524,764652,34712,177028,350812,24,0,302720,73524
3063,1065136,14216,548492,951908,385536,774840,34692,177068,350844,20,0,302464,73668
3072,1073252,14260,548976,945312,385964,768144,34696,177168,351268,168,0,301016,73340
3082,1079404,14276,548696,936472,385664,759268,34696,177204,350968,0,0,302388,73404
3092,1077880,14292,548796,937944,385760,760720,34696,177224,351064,40,8,302380,73424
3102,1079052,14352,548668,939356,385680,762120,34696,177236,350984,36,0,302408,73484
3112,1067844,14412,548796,949020,385812,771728,34696,177292,351116,0,0,302428,73496
3122,1069660,14420,548804,948740,385804,771424,34696,177316,351108,28,0,302352,73460
3133,1078744,14452,548808,937692,385808,760344,34696,177348,351112,8,0,302352,73380
3142,1077148,14524,548764,940940,385812,763572,34696,177368,351116,68,0,302756,73428
3152,1067540,14684,548772,947900,385840,770388,34696,177512,351144,52,0,301920,73564
3162,1069052,14844,548764,945876,385900,768272,34696,177604,351204,0,0,302824,73896
3173,1066316,15068,549064,949620,386288,771880,34712,177740,351576,96,0,302948,73868
3182,1074944,15120,549044,941896,386276,764112,34712,177784,351564,0,0,302656,73784
3193,1070208,15164,549072,945104,386332,767304,34712,177800,351620,24,0,302736,73808
3202,1071828,15180,549056,945196,386324,767388,34712,177808,351612,48,0,302676,73744
3213,1058312,15264,549068,958708,386348,780836,34708,177872,351640,4,32,302724,73728
3222,1087188,15460,549468,929712,386892,751780,34696,177932,352196,188,0,301080,73556
3232,1078176,15484,549164,938448,386608,760512,34696,177936,351912,4,0,302316,73680
3243,1072016,15508,549196,943416,386592,765408,34696,178008,351896,12,0,302604,73636
3252,1074632,15556,549072,942092,386508,764076,34696,178016,351812,4,0,302364,73680
3262,1064648,15588,549204,952280,386604,774196,34696,178084,351908,52,4,302384,73684
3272,1065224,15616,549212,951916,386608,773800,34696,178116,351912,92,0,302384,73704
3283,1073860,15640,549208,942688,386560,764504,34696,178184,351864,4,0,302388,73704
3292,1053264,15716,549124,963168,386560,784992,34696,178176,351864,72,0,302732,73752
3302,1066460,15960,549140,949032,386640,770676,34696,178356,351944,52,0,302832,73928
3312,1068704,16180,549236,945532,386824,767044,34696,178488,352128,204,0,302716,73820
3322,1055660,16284,550404,958720,387876,780012,35620,178708,352256,188,0,303892,74036
3332,1059612,16324,552820,952212,390204,773376,37848,178836,352356,112,0,305852,73848
3342,1048720,16368,553784,960896,392116,783004,39832,177892,352284,196,0,308476,74264
3353,1054856,16384,556996,954696,393880,775300,41692,179396,352188,168,0,310248,73912
3362,1057048,16408,557012,949652,393900,770236,41692,179416,352208,0,0,310252,73896
3373,1056068,16576,557068,951724,394020,772280,41692,179444,352328,12,0,310480,73952
3382,1057812,16600,557204,949336,394240,769876,41692,179460,352548,72,0,310260,73864
3392,1067352,16608,557188,943044,394200,763552,41692,179492,352508,80,4,310080,73612
3402,1072092,16640,557324,938672,394292,759104,41692,179568,352600,140,0,308504,73432
3413,1068860,16676,557040,941316,394012,761716,41692,179600,352320,16,0,309704,73616
3423,1064724,16708,556664,945568,393700,765908,41692,179660,352008,28,0,309752,73600
3432,1055692,16744,556936,952816,393892,773132,41692,179684,352200,16,36,309780,73660
3442,1053412,16776,557056,954272,394032,774576,41692,179696,352340,64,0,309780,73632
3452,1057064,16792,557064,953864,394036,774148,41692,179716,352344,24,0,309828,73664
3462,1063136,16824,557068,946900,394040,767152,41692,179748,352348,28,0,309792,73556
3472,1061236,16876,556988,948992,393944,769176,41692,179816,352252,80,8,310204,73596
3483,1057664,16936,556952,951812,393928,771960,41692,179852,352236,332,0,310360,73608
3492,1055044,16956,557112,953908,394112,774056,41692,179852,352420,32,0,310140,73620
3502,1056768,16976,557120,951744,394116,771868,41692,179876,352424,60,4,310052,73644
3512,1053360,17036,557120,956288,394148,776384,41696,179904,352452,40,0,310056,73608
3523,1052556,17076,557320,957448,394352,777512,41876,179936,352476,36,0,310296,73704
3532,1053148,17100,557132,955292,394172,775336,41692,179956,352480,20,0,310168,73512
3542,1056932,17120,557148,953608,394168,773612,41692,179996,352476,16,0,310064,73508
3553,1062288,17144,557156,946940,394172,766916,41692,180024,352480,0,0,310072,73676
3562,1067444,17156,557160,942696,394164,762648,41692,180048,352472,44,0,309844,73540
3573,1065936,17172,557168,944036,394168,763968,41692,180068,352476,16,0,309716,73560
3582,1065444,17240,557056,944552,394108,764468,41692,180084,352416,4,0,309800,73608
3592,1058296,17264,557192,952276,394200,772140,41692,180136,352508,548,0,309840,73596
3602,1055044,17276,557208,954744,394224,774588,41692,180156,352532,24,0,309856,73672
3612,1056432,17292,557216,953920,394228,773744,41692,180176,352536,20,0,309812,73604
3623,1059248,17356,557152,950636,394172,770404,41692,180232,352480,372,0,310132,73564
3633,1056080,17564,557160,952232,394316,771932,41692,180300,352624,148,4,309648,73404
3642,1046988,17672,557192,959624,394348,779212,41692,180412,352656,40,0,310320,73996
3652,1047948,17848,557396,960408,394520,779792,41692,180616,352828,68,0,310376,73784
3663,1054320,17864,557400,955476,394524,774840,41692,180636,352832,16,0,310044,73716
3672,1043956,17916,557384,961764,394508,781076,41696,180688,352812,52,0,310048,73676
3682,1049588,17944,557420,957980,394516,777236,41696,180744,352820,48,0,309960,73716
3692,1053816,17960,557432,956048,394524,775284,41692,180764,352832,0,0,310064,73648
3703,1061528,17976,557444,947732,394532,766948,41692,180784,352840,48,0,310068,73736
3713,1073324,17996,557740,935460,394792,754620,41692,180840,353100,200,0,308788,73568
3723,1063672,18012,557456,944212,394516,763364,41692,180848,352824,0,0,309984,73636
3733,1060632,18036,557476,948668,394536,767796,41708,180872,352828,92,0,309856,73664
3743,1057672,18076,557396,951316,394484,770432,41704,180884,352780,60,0,309876,73632
3753,1047396,18256,557480,962136,394664,781168,41708,180968,352956,60,0,309980,73644
3764,1039368,18356,557520,968944,394736,787908,41692,181036,353044,44,0,310468,73616
3773,1072352,18372,557900,937604,395096,756532,41692,181072,353404,40,0,308716,73460
3783,1062392,18400,557648,945612,394824,764492,41692,181120,353132,76,0,309836,73580
3793,1056448,18440,557748,952436,394856,771308,41692,181128,353164,332,0,309888,73672
3803,1045240,18496,562724,960280,399688,778852,41692,181428,357996,4,0,309980,73672
3813,1050856,18540,562856,952156,399792,770656,41692,181500,358100,76,0,309984,73820
3823,1050704,18772,563084,953176,400132,771612,41692,181564,358440,84,48,310300,73500
3833,1052944,18792,563168,951740,400192,770080,41692,181660,358500,8,0,310728,73344
3844,1054048,18796,563720,949468,400724,767780,41692,181688,359032,0,0,311168,73340
3853,1053000,18800,564016,950872,400996,769156,41692,181716,359304,40,0,311272,73388
3863,1043396,18940,565040,958700,401988,776812,41696,181888,360292,184,0,312124,73472
3873,1047136,19744,565420,953324,403108,771372,41696,181952,361412,44,0,311892,73432
3884,1044152,20428,566124,955560,404332,773496,41696,182064,362636,268,0,312228,73492
3893,1048656,20468,566264,954572,403396,771340,41696,183232,361700,96,0,311188,73488
3904,1044636,20584,566920,957308,404064,773980,41692,183328,362372,280,0,311576,73528
3914,1045128,20628,567004,955304,403936,771716,41692,183588,362244,88,0,312252,73408
3924,1035804,20652,567188,963264,404096,779632,41692,183632,362404,68,16,312728,73584
3934,1058220,20664,567000,943384,403872,759700,41692,183684,362180,0,0,310844,73300
3945,1050232,20672,567016,950300,403860,766580,41692,183720,362168,48,0,312036,73428
3954,1039700,20696,567168,959416,404088,775748,41904,183668,362184,88,0,312336,73424
3965,1039164,20716,567260,959216,404160,775508,41972,183708,362188,4,0,312404,73464
3974,1047400,20720,568684,949832,405540,766076,43396,183756,362144,92,0,313844,73448
3984,1018512,20744,569044,973256,405792,789368,43452,183888,362340,88,0,313904,73424
3995,1221820,20816,568684,829132,388288,628088,43284,201044,345004,112,4,295052,72196
4005,1233932,20848,569052,816544,388648,615452,43296,201092,345352,228,0,297248,72244
4016,1235900,20860,568792,814072,388368,612948,43296,201124,345072,40,0,296940,72180
4025,1235968,20876,568796,813888,388372,612748,43296,201140,345076,40,0,297036,72204
4035,1227124,20900,568824,822380,388400,621216,43312,201164,345088,0,0,297144,72252
4045,1227172,20916,567624,823136,388448,623204,43340,199932,345108,268,0,297256,72276
4056,1227640,20936,569000,823056,388580,621860,43312,201196,345268,8,0,297196,72276
4066,1226776,20952,568972,822572,388376,621184,43312,201388,345064,152,0,297212,72172
4075,1226120,20956,569284,821224,388664,619808,43312,201416,345352,144,0,297244,72208
4086,1233964,20972,569008,816040,388360,614580,43312,201460,345048,4,0,297304,72112
4096,1235124,20980,569016,814324,388352,612840,43312,201484,345040,28,0,297176,72164
4105,1232956,20988,569380,815740,388720,614252,43312,201488,345408,0,0,297460,72184
4116,1243328,21000,569696,807560,389004,606028,43312,201532,345692,136,0,296048,72008
4125,1233028,21008,569388,816080,388696,614540,43312,201540,345384,4,0,297272,72164
4135,1230352,21016,569424,819072,388704,617496,43312,201576,345392,44,0,297348,72148
4145,1231492,21024,569428,818200,388692,616600,43312,201600,345380,20,0,297404,72148
4155,1243616,21032,569728,806720,388964,605084,43312,201636,345652,0,0,296060,72024
4165,1231772,21040,569444,817280,388660,615616,43312,201664,345348,28,0,297268,72156
4176,1175320,21404,573596,858032,392976,656220,43308,201812,349668,116,0,298640,72220
4185,1169140,21464,574612,861620,393900,659604,43312,202016,350588,4,0,299136,72264
4195,1166652,21480,574604,864148,393904,662128,43312,202020,350592,52,0,299176,72248
4205,1166944,21480,574628,863916,393896,661864,43312,202052,350584,0,0,299160,72272
4215,1164896,21488,574648,865748,393848,663668,43312,202080,350536,396,0,299212,72316
4225,1148708,21504,574776,881756,393976,679612,43312,202144,350664,440,0,299196,72284
4235,1383928,21536,531604,788520,342832,578372,392,210148,342440,8,0,230120,71200
4245,1380068,21692,532236,791288,343364,580884,392,210404,342972,432,0,230220,71292
4255,1406236,21708,532260,765820,343348,555360,392,210460,342956,36,0,230240,71272
4265,1409896,21720,531852,762856,342932,552376,392,210480,342540,4,0,229760,71144
4275,1388760,21724,531852,784096,342908,573588,392,210508,342516,4,0,229868,71208
4285,1399668,21732,531708,773488,342772,562980,392,210508,342380,96,0,229880,71184
4295,1399180,21744,531740,773876,342784,563336,392,210540,342392,52,0,229864,71160
4305,1386316,21748,533724,784168,344252,573608,392,210560,343860,20,0,229648,71100
4315,1367424,21792,534300,799992,345324,589384,392,210608,344932,68,8,231028,71080
4326,1370404,21832,534468,798196,345456,587512,392,210684,345064,48,0,231024,71152
4335,1367452,21848,534464,799692,345452,588992,392,210700,345060,4,0,230984,71168
4345,1370420,21852,534480,797200,345436,586464,392,210736,345044,56,0,230516,71112
4355,1372148,21864,534488,796220,345440,585468,392,210752,345048,80,0,230548,71152
4365,1369500,21884,534440,797284,345416,586536,392,210748,345024,32,0,230628,71180
4375,1369976,21900,534428,798068,345420,587320,392,210748,345028,44,0,230644,71180
4385,1368988,21912,534440,798612,345436,587856,392,210756,345044,32,0,230660,71208
4395,1369020,21928,534456,798504,345436,587716,392,210788,345044,0,0,230628,71228
4405,1333988,22096,536092,814152,346936,603060,392,211092,346544,68,0,231812,71380
4415,1322736,22140,537320,824448,347704,612852,392,211596,347312,4,0,235192,71552
4425,1314692,22208,537572,829768,347888,618132,392,211636,347496,24,0,236244,71576
4435,1314284,22244,538136,831368,348412,619560,524,211808,347888,44,0,242440,71664
4445,1297788,22308,538316,839496,348612,627644,520,211852,348092,4,0,242528,71684
